01101000
01100101
01101100
01101100
01101111
01011111
01110111
01101111
01110010
01101100
01100100
00101110
01110100
01111000
01110100

01110111
01101000
01100001
01110100
01011111
01101001
01110011
01011111
01101100
01101111
01110110
01100101
00111111
00111100
00110011